Afghanistan -> Afghanistan
Albania -> Albania
Algeria -> Algeria
Andorra -> Andorra
Angola -> Angola
Antigua and Barbuda -> Antigua and Barbuda
Argentina -> Argentina
Armenia -> Armenia
Australia -> Australia
Austria -> Austria
Azerbaijan -> Azerbaijan
Bahamas -> Bahamas, The
Bahrain -> Bahrain
Bangladesh -> Bangladesh
Barbados -> Barbados
Belarus -> Belarus
Belgium -> Belgium
Belize -> Belize
Benin -> Benin
Bhutan -> Bhutan
Bolivia (Plurinational State of) -> Bolivia
Bosnia and Herzegovina -> Bosnia and Herzegovina
Botswana -> Botswana
Brazil -> Brazil
Brunei Darussalam -> Brunei Darussalam
Bulgaria -> Bulgaria
Burkina Faso -> Burkina Faso
Burundi -> Burundi
Cabo Verde -> Cabo Verde
Cambodia -> Cambodia
Cameroon -> Cameroon
Canada -> Canada
Central African Republic -> Central African Republic
Chad -> Chad
Chile -> Chile
China -> China
Colombia -> Colombia
Comoros -> Comoros
Congo -> Congo, Dem. Rep.
Cook Islands -> Cook Islands
Costa Rica -> Costa Rica
Cote d'Ivoire -> Cote d'Ivoire
Croatia -> Croatia
Cuba -> Cuba
Cyprus -> Cyprus
Czechia -> Czechia
Democratic People's Republic of Korea -> Democratic People's Republic of Korea
Democratic Republic of the Congo -> Congo
Denmark -> Denmark
Djibouti -> Djibouti
Dominica -> Dominica
Dominican Republic -> Dominican Republic
Ecuador -> Ecuador
Egypt -> Egypt, Arab Rep.
El Salvador -> El Salvador
Equatorial Guinea -> Equatorial Guinea
Eritrea -> Eritrea
Estonia -> Estonia
Eswatini -> Eswatini
Ethiopia -> Ethiopia
Fiji -> Fiji
Finland -> Finland
France -> France
Gabon -> Gabon
Gambia -> Gambia, The
Georgia -> Georgia
Germany -> Germany
Ghana -> Ghana
Greece -> Greece
Grenada -> Grenada
Guatemala -> Guatemala
Guinea -> Guinea
Guinea-Bissau -> Guinea-Bissau
Guyana -> Guyana
Haiti -> Haiti
Honduras -> Honduras
Hungary -> Hungary
Iceland -> Iceland
India -> India
Indonesia -> Indonesia
Iran -> Iran
Iraq -> Iraq
Ireland -> Ireland
Israel -> Israel
Italy -> Italy
Jamaica -> Jamaica
Japan -> Japan
Jordan -> Jordan
Kazakhstan -> Kazakhstan
Kenya -> Kenya
Kiribati -> Kiribati
Kuwait -> Kuwait
Kyrgyzstan -> Kyrgyzstan
Lao People's Democratic Republic -> Lao People's Democratic Republic
Latvia -> Latvia
Lebanon -> Lebanon
Lesotho -> Lesotho
Liberia -> Liberia
Libya -> Libya
Lithuania -> Lithuania
Luxembourg -> Luxembourg
Madagascar -> Madagascar
Malawi -> Malawi
Malaysia -> Malaysia
Maldives -> Maldives
Mali -> Mali
Malta -> Malta
Marshall Islands -> Marshall Islands
Mauritania -> Mauritania
Mauritius -> Mauritius
Mexico -> Mexico
Micronesia (Federated States of) -> Micronesia (Federated States of)
Monaco -> Monaco
Mongolia -> Mongolia
Montenegro -> Montenegro
Morocco -> Morocco
Mozambique -> Mozambique
Myanmar -> Myanmar
Namibia -> Namibia
Nauru -> Nauru
Nepal -> Nepal
Netherlands (Kingdom of the) -> Netherlands
New Zealand -> New Zealand
Nicaragua -> Nicaragua
Niger -> Niger
Nigeria -> Nigeria
Niue -> Niue
North Macedonia -> North Macedonia
Norway -> Norway
Oman -> Oman
Pakistan -> Pakistan
Palau -> Palau
Panama -> Panama
Papua New Guinea -> Papua New Guinea
Paraguay -> Paraguay
Peru -> Peru
Philippines -> Philippines
Poland -> Poland
Portugal -> Portugal
Qatar -> Qatar
Republic of Korea -> Korea, Rep.
Republic of Moldova -> Moldova
Romania -> Romania
Russian Federation -> Russian Federation
Rwanda -> Rwanda
Saint Kitts and Nevis -> St. Kitts and Nevis
Saint Lucia -> St. Lucia
Saint Vincent and the Grenadines -> St. Vincent and the Grenadines
Samoa -> Samoa
San Marino -> San Marino
Sao Tome and Principe -> Sao Tome and Principe
Saudi Arabia -> Saudi Arabia
Senegal -> Senegal
Serbia -> Serbia
Seychelles -> Seychelles
Sierra Leone -> Sierra Leone
Singapore -> Singapore
Slovakia -> Slovakia
Slovenia -> Slovenia
Solomon Islands -> Solomon Islands
Somalia -> Somalia
South Africa -> South Africa
South Sudan -> South Sudan
Spain -> Spain
Sri Lanka -> Sri Lanka
Sudan -> Sudan
Suriname -> Suriname
Sweden -> Sweden
Switzerland -> Switzerland
Syrian Arab Republic -> Syrian Arab Republic
Tajikistan -> Tajikistan
Thailand -> Thailand
Timor-Leste -> Timor-Leste
Togo -> Togo
Tonga -> Tonga
Trinidad and Tobago -> Trinidad and Tobago
Tunisia -> Tunisia
Turkmenistan -> Turkmenistan
Tuvalu -> Tuvalu
T�rkiye -> T�rkiye
Uganda -> Uganda
Ukraine -> Ukraine
United Arab Emirates -> United Arab Emirates
United Kingdom of Great Britain and Northern Ireland -> United Kingdom of Great Britain and Northern Ireland
United Republic of Tanzania -> Tanzania
United States of America -> United States
Uruguay -> Uruguay
Uzbekistan -> Uzbekistan
Vanuatu -> vana
Venezuela (Bolivarian Republic of) -> Venezuela
Viet Nam -> Viet Nam
Yemen -> Yemen
Zambia -> Zambia
Zimbabwe -> Zimbabwe

